00000000000000000001110000000111
00000000000000000001110000000111
00000000000000000001110000000111
00000000000000000001110000000111
00000000000000000001110000000111
00000000000000000011111000000000
10000001110000000111111100000001
10000001110000001111111110000000
